                                                                               
                                                                               
            #################               ##################                 
            #               #               #                #                 
            #    +-----+    #               #    +------+    #####             
            #    |#####|    #               #    |######|        #             
            #    |#####|    #               #    |######|    #####             
            #    +-----+    #               #    +------+    #                 
            #       &       #               #       &        #                 
        #####               #               #           g    #                 
        2@          g       #               #       O        #                 
        #####               #################           g    #                 
            #       &                               &        #                 
            #    +-----+         +-----+         +------+    #                 
            #    |#####|&   g   &|#####|&   g   &|######|    #                 
            #    |#####|         |#####|         |######|    #                 
            #    +-----+         +-----+         +------+    #                 
            #                                                #                 
            ##################################################                 
                                                                               
                                                                                