####################################################
#@  ####   #                         ###############
#          #         ###########     ###############
########   #         #         #     ###############
###  g #   #         #         #                   #
### ## #   #         #   ggg   ########            #
### ####   #   g g   #   g g                 g     #
### ####   #    O    #                             #
### ####   #         #                ##############
### ####   ###########                #            #
###                               #####            #
######################                          D  #
###################### ################            #
###################### ################            #
#                      #############################
### ##### ##### ####################################
#     #     #  O  ##################################
#  g  #     #     ##################################
####################################################