                                                                               
                                                                               
                                                                               
                                                                               
                     ###############        ###############                    
                     #&           &#        #&           &#                    
                     #             #        #             #                    
                     #         g   #        #      g      #                    
                     #             #        #             #                    
                   ###     +-+    &##########&    +-+     ###                  
                   1  @    |#|                    |#|  g    3                  
                   ###     +-+    &##########&    +-+     ###                  
                     #             #        #             #                    
                     #         g   #        #      g      #                    
                     #             #        #             #                    
                     #&           &#        #&           &#                    
                     ###############        ###############                    
                                                                               
                                                                               
                                                                               
                                                                                