                                                                               
                                                                               
                                                                               
                                                                               
                     ###############        ###############                    
                     #&           &#        #&           &#                    
                     #             #        #             #                    
                     #             #        #             #                    
                     #             #        #             #                    
                     #            &##########&       g    #                    
                     1@                              O    3                    
                     #            &##########&       g    #                    
                     #             #        #             #                    
                     #             #        #             #                    
                     #             #        #             #                    
                     #&           &#        #&           &#                    
                     ###############        ###############                    
                                                                               
                                                                               
                                                                               
                                                                                